110010101101011
010110101101011
011001111011110
111101101111011
110111100111011
010111111011110
011001101111011
111101101111011
110111100111011
010111101111001
011001101111001
111101101111001
110111011110011
111101101111001
110111011110011